12 12 12 12 12 12 12 12 12 12 12 12 12 12 12 12 12 12 12 12 12 12 12 12 12 12 12 12 12 12 12 12 12 12 12 12 12 12 12 12 12 12 12 12 12 12 12 12 12 12 12 12 12 12 12 12 12 12 12 12
12 12 12 12 12 12 12 12 12 12 12 12 12 12 12 12 12 12 12 12 12 12 12 12 12 12 12 12 12 12 12 12 12 12 12 12 12 12 12 12 12 12 12 12 12 12 12 12 12 12 12 12 12 12 12 12 12 12 12 12
12 12 12 12 12 13 12 12 12 12 12 13 12 12 12 12 12 13 12 12 12 12 12 13 12 12 12 12 12 13 12 12 12 12 12 13 12 12 12 12 12 13 12 12 12 12 12 13 12 12 12 12 12 13 12 12 12 12 12 13
13 12 12 12 12 12 13 12 12 12 12 12 13 12 12 12 12 12 13 12 12 12 12 12 13 12 12 12 12 12 13 12 12 12 12 12 13 12 12 12 12 12 13 12 12 12 12 12 13 12 12 12 12 12 13 12 12 12 12 12
12 12 12 12 12 13 12 12 12 12 12 13 12 12 12 12 12 13 12 12 12 12 12 13 12 12 12 12 12 13 12 12 12 12 12 13 12 12 12 12 12 13 12 12 12 12 12 13 12 12 12 12 12 13 12 12 12 12 12 13
13 12 12 12 12 12 13 12 12 12 12 12 13 12 12 12 12 12 13 12 12 12 12 12 13 12 12 12 12 12 13 12 12 12 12 12 13 12 12 12 12 12 13 12 12 12 12 12 13 12 12 12 12 12 12 13 12 13 12 12
12 12 13 12 13 12 35 33 33 33 33 33 33 33 33 33 33 33 33 33 33 33 33 33 33 33 33 33 33 33 33 33 33 33 33 33 33 33 33 33 33 33 33 33 33 33 33 33 33 33 33 33 33 36 12 12 12 12 12 12
12 12 12 12 12 12 31 11 11 11 11 11 11 11 11 11 11 11 11 11 11 11 11 11 11 11 11 11 11 11 11 11 11 11 11 11 11 11 11 11 11 11 11 11 11 11 11 11 11 11 11 11 11 30 12 12 12 12 12 12
12 12 12 12 12 12 31 11 41 41 41 41 41 41 41 41 41 41 41 41 41 41 41 41 41 41 14 15 15 15 15 15 16 41 41 41 41 41 41 41 41 41 41 41 41 41 41 41 41 41 41 41 39 30 12 12 12 12 12 12
12 12 12 12 12 12 31 11 41 27 28 28 28 29 41 39 40 40 40 40 40 40 40 40 40 41 17 12 12 13 12 12 18 41 40 40 40 40 40 40 40 40 40 41 39 41 27 28 28 28 29 41 39 30 12 12 12 12 12 12
12 12 12 12 12 12 31 11 41 30 40 40 40 31 41 39 40 42 42 42 42 42 42 42 40 41 17 12 13 12 12 13 18 41 40 42 42 42 42 42 42 42 40 41 39 41 30 40 40 40 31 41 39 30 12 12 12 12 12 12
12 12 12 12 12 12 31 11 41 30 40 41 41 31 41 39 40 42 12 12 13 12 12 42 40 41 17 12 12 13 12 12 18 41 40 42 12 12 13 12 12 42 40 41 39 41 30 40 41 41 31 41 39 30 13 13 13 13 12 12
12 12 13 13 13 13 31 11 41 30 40 41 41 31 41 39 40 42 13 12 12 12 13 42 40 41 17 12 13 12 12 13 18 41 40 42 13 12 12 12 13 42 40 41 39 41 30 40 41 41 31 41 39 30 12 12 12 12 12 12
12 12 12 12 12 12 31 11 41 30 40 41 41 31 41 39 40 42 12 12 13 12 12 42 40 41 17 12 12 13 12 12 18 41 40 42 12 12 13 12 12 42 40 41 39 41 30 40 41 41 31 41 39 30 12 12 12 12 12 12
12 12 12 12 12 12 31 11 41 30 40 41 41 31 41 39 40 42 13 12 12 12 13 42 40 41 17 12 13 12 12 13 18 41 40 42 13 12 12 12 13 42 40 41 39 41 30 40 41 41 31 41 39 30 12 12 12 12 12 12
12 12 12 12 12 12 31 11 41 30 40 43 41 31 41 39 40 42 12 12 13 12 12 42 40 41 17 12 12 13 12 12 18 41 40 42 12 12 13 12 12 42 40 41 39 41 30 40 43 41 31 41 39 30 12 12 12 12 12 12
12 12 12 12 12 12 31 11 41 30 40 43 43 39 39 39 40 42 13 12 12 12 13 42 40 41 17 12 13 12 12 13 18 41 40 42 13 12 12 12 13 42 40 41 39 41 30 40 43 43 39 39 39 30 12 12 12 12 12 12
12 12 12 12 12 12 31 11 41 30 40 43 41 31 41 39 40 42 12 12 13 12 12 42 40 41 17 12 12 13 12 12 18 41 40 42 12 12 13 12 12 42 40 41 39 41 30 40 43 41 31 41 39 30 13 13 13 13 12 12
12 12 13 13 13 13 31 11 41 30 40 41 41 31 41 39 40 42 13 12 12 12 13 42 40 41 19 20 20 20 20 20 21 41 40 42 13 12 12 12 13 42 40 41 39 41 30 40 41 41 31 41 39 30 12 12 12 12 12 12
12 12 12 12 12 12 31 11 41 30 40 41 41 31 41 39 40 42 12 12 13 12 12 42 40 41 41 41 41 39 41 41 41 41 40 42 12 12 13 12 12 42 40 41 39 41 30 40 41 41 31 41 39 30 12 12 12 12 12 12
12 12 12 12 12 12 31 11 41 30 40 41 41 31 41 39 40 42 13 12 12 12 13 42 40 41 41 41 41 39 41 41 41 41 40 42 13 12 12 12 13 42 40 41 39 41 30 40 41 41 31 41 39 30 12 12 12 12 12 12
12 12 12 12 12 12 31 11 41 30 40 40 40 31 41 39 40 42 42 42 42 42 42 42 40 41 41 41 41 39 41 41 41 41 40 42 12 12 13 12 12 42 40 41 39 41 30 40 40 40 31 41 39 30 12 12 12 12 12 12
12 12 12 12 12 12 31 11 41 32 33 33 33 34 41 39 40 42 42 42 42 42 42 42 40 41 41 41 41 39 41 41 41 41 40 42 13 12 12 12 13 42 40 41 39 41 32 33 33 33 34 39 39 30 12 12 12 12 12 12
12 12 12 12 12 12 31 11 41 41 41 41 41 41 41 39 40 42 41 41 42 41 41 42 40 41 41 41 41 39 41 41 41 41 40 42 12 12 13 12 12 42 40 41 39 41 39 39 39 39 39 39 39 30 13 13 13 13 12 12
12 12 13 13 13 13 31 11 11 11 11 11 11 11 11 39 40 42 41 41 42 41 41 42 40 41 41 41 41 39 41 41 41 41 40 42 13 12 12 12 13 42 40 41 39 14 15 15 15 15 15 16 11 30 12 12 12 12 12 12
12 12 12 12 12 12 31 11 14 15 15 15 15 15 16 39 40 42 41 41 42 41 41 42 40 41 41 41 41 39 41 41 41 41 40 42 12 12 13 12 12 42 40 41 39 17 12 12 13 12 12 18 11 30 12 12 12 12 12 12
12 12 12 12 12 12 31 11 17 12 13 12 12 13 18 39 40 42 42 42 42 42 42 42 40 41 41 41 41 39 41 41 41 41 40 42 42 42 42 42 42 42 40 41 39 17 12 13 12 12 13 18 11 30 12 12 12 12 12 12
12 12 12 12 12 12 31 11 17 12 12 13 12 12 18 39 40 40 40 39 39 39 40 40 40 41 41 41 41 39 41 41 41 41 40 40 40 39 39 39 40 40 40 41 39 17 12 12 13 12 12 18 11 30 12 12 12 12 12 12
12 12 12 12 12 12 31 11 17 12 13 12 12 13 18 39 41 41 41 39 39 39 41 41 41 41 41 41 41 39 41 41 41 41 41 41 41 39 39 39 41 41 41 41 39 17 12 13 12 12 13 18 11 30 12 12 12 12 12 12
12 12 12 12 12 12 31 11 17 12 12 13 12 12 18 39 39 39 39 39 39 39 39 39 39 39 39 39 39 39 39 39 39 39 39 39 39 39 39 39 39 39 39 39 39 17 12 12 13 12 12 18 11 30 13 13 13 13 12 12
12 12 13 13 13 13 31 11 17 12 13 12 12 13 18 39 41 41 41 41 41 41 41 41 41 41 41 41 41 39 41 41 41 41 41 41 41 41 41 41 41 41 41 41 39 17 12 13 12 12 13 18 11 30 12 12 12 12 12 12
12 12 12 12 12 12 31 11 17 12 12 13 12 12 18 39 40 40 40 40 40 40 40 40 40 41 41 41 41 39 41 41 41 41 40 40 40 40 40 40 40 40 40 41 39 17 12 12 13 12 12 18 11 30 12 12 12 12 12 12
12 12 12 12 12 12 31 11 17 12 13 12 12 13 18 39 40 42 42 42 42 42 42 42 40 41 41 41 41 39 41 41 41 41 40 42 42 42 42 42 42 42 40 41 39 17 12 13 12 12 13 18 11 30 12 12 12 12 12 12
12 12 12 12 12 12 31 11 17 12 12 13 12 12 18 39 40 42 12 12 13 12 12 42 40 41 41 41 41 39 41 41 41 41 40 42 12 12 13 12 12 42 40 41 39 17 12 12 13 12 12 18 11 30 12 12 12 12 12 12
12 12 12 12 12 12 31 11 19 20 20 20 20 20 21 39 40 42 13 12 12 12 13 42 40 41 41 41 41 39 41 41 41 41 40 42 13 12 12 12 13 42 40 41 39 19 20 20 20 20 20 21 11 30 12 12 12 12 12 12
12 12 12 12 12 12 31 11 41 39 39 39 39 39 39 39 40 42 12 12 13 12 12 42 40 41 41 41 41 39 41 41 41 41 40 42 12 12 13 12 12 42 40 41 39 41 41 41 41 41 41 41 11 30 13 13 13 13 12 12
12 12 13 13 13 13 31 11 41 27 28 28 28 29 41 39 40 42 13 12 12 12 13 42 40 41 41 41 41 39 41 41 41 41 40 42 13 12 12 12 13 42 40 41 39 41 27 28 28 28 29 41 39 30 12 12 12 12 12 12
12 12 12 12 12 12 31 11 41 30 40 40 40 31 41 39 40 42 12 12 13 12 12 42 40 41 41 41 41 39 41 41 41 41 40 42 12 12 13 12 12 42 40 41 39 41 30 40 40 40 31 41 39 30 12 12 12 12 12 12
12 12 12 12 12 12 31 11 41 30 40 41 41 31 41 39 40 42 13 12 12 12 13 42 40 41 41 41 41 39 41 41 41 41 40 42 13 12 12 12 13 42 40 41 39 41 30 40 41 41 31 41 39 30 12 12 12 12 12 12
12 12 12 12 12 12 31 11 41 30 40 41 41 31 41 39 40 42 12 12 13 12 12 42 40 41 41 41 41 39 41 41 41 41 40 42 12 12 13 12 12 42 40 41 39 41 30 40 41 41 31 41 39 30 12 12 12 12 12 12
12 12 12 12 12 12 31 11 41 30 40 41 41 31 41 39 40 42 13 12 12 12 13 42 40 41 41 41 41 39 41 41 41 41 40 42 13 12 12 12 13 42 40 41 39 41 30 40 41 41 31 41 39 30 12 12 12 12 12 12
12 12 12 12 12 12 31 11 41 30 40 41 41 31 41 39 40 42 12 12 13 12 12 42 40 41 14 15 15 15 15 15 16 41 40 42 12 12 13 12 12 42 40 41 39 41 30 40 41 41 31 41 39 30 13 13 13 13 12 12
12 12 13 13 13 13 31 11 41 30 40 43 41 31 41 39 40 42 13 12 12 12 13 42 40 41 17 12 12 13 12 12 18 41 40 42 13 12 12 12 13 42 40 41 39 41 30 40 43 41 31 41 39 30 12 12 12 12 12 12
12 12 12 12 12 12 31 11 41 30 40 43 43 39 39 39 40 42 12 12 13 12 12 42 40 41 17 12 13 12 12 13 18 41 40 42 12 12 13 12 12 42 40 41 39 41 30 40 43 43 39 39 39 30 12 12 12 12 12 12
12 12 12 12 12 12 31 11 41 30 40 43 41 31 41 39 40 42 13 12 12 12 13 42 40 41 17 12 12 13 12 12 18 41 40 42 13 12 12 12 13 42 40 41 39 41 30 40 43 41 31 41 39 30 12 12 12 12 12 12
12 12 12 12 12 12 31 11 41 30 40 41 41 31 41 39 40 42 12 12 13 12 12 42 40 41 17 12 13 12 12 13 18 41 40 42 12 12 13 12 12 42 40 41 39 41 30 40 41 41 31 41 39 30 12 12 12 12 12 12
12 12 12 12 12 12 31 11 41 30 40 41 41 31 41 39 40 42 13 12 12 12 13 42 40 41 17 12 12 13 12 12 18 41 40 42 13 12 12 12 13 42 40 41 39 41 30 40 41 41 31 41 39 30 12 12 12 12 12 12
12 12 12 12 12 12 31 11 41 30 40 41 41 31 41 39 40 42 12 12 13 12 12 42 40 41 17 12 13 12 12 13 18 41 40 42 12 12 13 12 12 42 40 41 39 41 30 40 41 41 31 41 39 30 13 13 13 13 12 12
12 12 13 13 13 13 31 11 41 30 40 40 40 31 41 39 40 42 42 42 42 42 42 42 40 41 17 12 12 13 12 12 18 41 40 42 42 42 42 42 42 42 40 41 39 41 30 40 40 40 31 41 39 30 12 12 12 12 12 12
12 12 12 12 12 12 31 11 41 32 33 33 33 34 41 39 40 40 40 39 39 39 40 40 40 41 17 12 13 12 12 13 18 41 40 40 40 39 39 39 40 40 40 41 39 39 32 33 33 33 34 39 39 30 12 12 12 12 12 12
12 12 12 12 12 12 31 11 41 41 41 41 41 41 41 39 41 41 41 39 39 39 41 41 41 41 17 12 12 13 12 12 18 41 41 41 41 39 39 39 41 41 41 41 41 39 39 39 39 39 39 39 39 30 12 12 12 12 12 12
12 12 12 12 12 12 31 11 41 41 41 41 41 41 41 41 41 41 41 39 39 39 41 41 41 41 19 20 20 20 20 20 21 41 41 41 41 39 39 39 41 41 41 41 41 41 41 41 41 41 41 41 11 30 12 12 12 12 12 12
12 12 12 12 12 12 31 11 11 11 11 11 11 11 11 11 11 11 11 11 11 11 11 11 11 11 11 11 11 11 11 11 11 11 11 11 11 11 11 11 11 11 11 11 11 11 11 11 11 11 11 11 11 30 12 12 12 12 12 12
12 12 12 12 12 12 37 28 28 28 28 28 28 28 28 28 28 28 28 28 28 28 28 28 28 28 28 28 28 28 28 28 28 28 28 28 28 28 28 28 28 28 28 28 28 28 28 28 28 28 28 28 28 38 12 12 12 12 12 12
13 12 13 12 12 12 13 12 12 12 12 12 13 12 12 12 12 12 13 12 12 12 12 12 13 12 12 12 12 12 13 12 12 12 12 12 13 12 12 12 12 12 13 12 12 12 12 12 13 12 12 12 12 12 13 12 12 12 12 12
12 12 12 12 12 13 12 12 12 12 12 13 12 12 12 12 12 13 12 12 12 12 12 13 12 12 12 12 12 13 12 12 12 12 12 13 12 12 12 12 12 13 12 12 12 12 12 13 12 12 12 12 12 13 12 12 12 12 12 13
13 12 12 12 12 12 13 12 12 12 12 12 13 12 12 12 12 12 13 12 12 12 12 12 13 12 12 12 12 12 13 12 12 12 12 12 13 12 12 12 12 12 13 12 12 12 12 12 13 12 12 12 12 12 13 12 12 12 12 12
12 12 12 12 12 13 12 12 12 12 12 13 12 12 12 12 12 13 12 12 12 12 12 13 12 12 12 12 12 13 12 12 12 12 12 13 12 12 12 12 12 13 12 12 12 12 12 13 12 12 12 12 12 13 12 12 12 12 12 13
12 12 12 12 12 12 12 12 12 12 12 12 12 12 12 12 12 12 12 12 12 12 12 12 12 12 12 12 12 12 12 12 12 12 12 12 12 12 12 12 12 12 12 12 12 12 12 12 12 12 12 12 12 12 12 12 12 12 12 12
12 12 12 12 12 12 12 12 12 12 12 12 12 12 12 12 12 12 12 12 12 12 12 12 12 12 12 12 12 12 12 12 12 12 12 12 12 12 12 12 12 12 12 12 12 12 12 12 12 12 12 12 12 12 12 12 12 12 12 12
