12 12 12 12 12 12 12 12 12 12 12 12 12 12 12 12 12 12 12 12 12 12 12 12 12 12 12 12 12 12 12 12 12 12 12 12 12 12 12 12 12 12 12 12 12 12 12 12 12 12 12 12 12 12 12 12 12 12 12 12
12 12 12 12 12 12 12 12 12 12 12 12 12 12 12 12 12 12 12 12 12 12 12 12 12 12 12 12 12 12 12 12 12 12 12 12 12 12 12 12 12 12 12 12 12 12 12 12 12 12 12 12 12 12 12 12 12 12 12 12
12 12 12 12 12 13 12 12 12 12 12 13 12 12 12 12 12 13 12 12 12 12 12 13 12 12 12 12 12 13 12 12 12 12 12 13 12 12 12 12 12 13 12 12 12 12 12 13 12 12 12 12 12 13 12 12 12 12 12 13
13 12 12 12 12 12 13 12 12 12 12 12 13 12 12 12 12 12 13 12 12 12 12 12 13 12 12 12 12 12 13 12 12 12 12 12 13 12 12 12 12 12 13 12 12 12 12 12 13 12 12 12 12 12 13 12 12 12 12 12
12 12 12 12 12 13 12 12 12 12 12 13 12 12 12 12 12 13 12 12 12 12 12 13 12 12 12 12 12 13 12 12 12 12 12 13 12 12 12 12 12 13 12 12 12 12 12 13 12 12 12 12 12 13 12 12 12 12 12 13
13 12 12 12 12 12 13 12 12 12 12 12 13 12 12 12 12 12 13 12 12 12 12 12 13 12 12 12 12 12 13 12 12 12 12 12 13 12 12 12 12 12 13 12 12 12 12 12 13 12 12 12 12 12 12 13 12 13 12 12
12 12 13 12 13 12 27 28 28 28 28 28 28 28 28 28 28 28 28 28 28 28 28 28 28 28 28 28 28 28 28 28 28 28 28 28 28 28 28 28 28 28 28 28 28 28 28 28 28 28 28 28 28 29 12 12 12 12 12 12
12 12 12 12 12 12 30 11 11 11 11 11 11 11 11 11 11 11 11 11 11 11 11 11 11 11 11 11 11 11 11 11 11 11 11 11 11 11 11 11 11 11 11 11 11 11 11 11 11 11 11 11 11 31 12 12 12 12 12 12
12 12 12 12 12 12 30 11 41 41 41 41 41 41 41 39 41 41 41 41 41 41 41 41 41 41 14 15 15 15 15 15 16 41 41 41 41 41 41 41 41 41 41 41 41 39 39 39 39 39 39 39 39 31 12 12 12 12 12 12
12 12 12 12 12 12 30 11 41 27 28 28 28 29 41 39 40 40 40 40 40 40 40 40 40 41 17 12 12 13 12 12 18 41 40 40 40 40 40 40 40 40 40 41 39 39 27 28 28 28 29 41 39 31 12 12 12 12 12 12
12 12 12 12 12 12 30 11 41 30 40 40 40 31 41 39 40 42 42 42 42 42 42 42 40 41 17 12 13 12 12 13 18 41 40 42 42 42 42 42 42 42 40 41 39 41 30 40 40 40 31 41 39 31 12 12 12 12 12 12
12 12 12 12 12 12 30 11 41 30 40 41 41 31 41 39 40 42 12 12 13 12 12 42 40 41 17 12 12 13 12 12 18 41 40 42 12 12 13 12 12 42 40 41 39 41 30 40 41 41 31 41 39 31 13 13 13 13 12 12
12 12 13 13 13 13 30 11 41 30 40 41 41 31 41 39 40 42 13 12 12 12 13 42 40 41 17 12 13 12 12 13 18 41 40 42 13 12 12 12 13 42 40 41 39 41 30 40 41 41 31 41 39 31 12 12 12 12 12 12
12 12 12 12 12 12 30 11 41 30 40 41 41 31 41 39 40 42 12 12 13 12 12 42 40 41 17 12 12 13 12 12 18 41 40 42 12 12 13 12 12 42 40 41 39 41 30 40 41 41 31 41 39 31 12 12 12 12 12 12
12 12 12 12 12 12 30 11 41 30 40 41 41 31 41 39 40 42 13 12 12 12 13 42 40 41 17 12 13 12 12 13 18 41 40 42 13 12 12 12 13 42 40 41 39 41 30 40 41 41 31 41 39 31 12 12 12 12 12 12
12 12 12 12 12 12 30 11 41 30 40 43 41 31 41 39 40 42 12 12 13 12 12 42 40 41 17 12 12 13 12 12 18 41 40 42 12 12 13 12 12 42 40 41 39 41 30 40 43 41 31 41 39 31 12 12 12 12 12 12
12 12 12 12 12 12 30 11 41 30 40 43 43 39 39 39 40 42 13 12 12 12 13 42 40 41 17 12 13 12 12 13 18 41 40 42 13 12 12 12 13 42 40 41 39 41 30 40 43 43 39 39 39 31 12 12 12 12 12 12
12 12 12 12 12 12 30 11 41 30 40 43 41 31 41 39 40 42 12 12 13 12 12 42 40 41 17 12 12 13 12 12 18 41 40 42 12 12 13 12 12 42 40 41 39 41 30 40 43 41 31 41 39 31 13 13 13 13 12 12
12 12 13 13 13 13 30 11 41 30 40 41 41 31 41 39 40 42 13 12 12 12 13 42 40 41 19 20 20 20 20 20 21 41 40 42 13 12 12 12 13 42 40 41 39 41 30 40 41 41 31 41 39 31 12 12 12 12 12 12
12 12 12 12 12 12 30 11 41 30 40 41 41 31 41 39 40 42 12 12 13 12 12 42 40 41 41 41 41 39 41 41 41 41 40 42 12 12 13 12 12 42 40 41 39 41 30 40 41 41 31 41 39 31 12 12 12 12 12 12
12 12 12 12 12 12 30 11 41 30 40 41 41 31 41 39 40 42 13 12 12 12 13 42 40 41 41 41 41 39 41 41 41 41 40 42 13 12 12 12 13 42 40 41 39 41 30 40 41 41 31 41 39 31 12 12 12 12 12 12
12 12 12 12 12 12 30 11 41 30 40 40 40 31 41 39 40 42 42 42 42 42 42 42 40 41 41 41 41 39 41 41 41 41 40 42 12 12 13 12 12 42 40 41 39 41 30 40 40 40 31 41 39 31 12 12 12 12 12 12
12 12 12 12 12 12 30 11 41 32 33 33 33 34 41 39 40 42 42 42 42 42 42 42 40 41 41 41 41 39 41 41 41 41 40 42 13 12 12 12 13 42 40 41 39 41 32 33 33 33 34 39 39 31 12 12 12 12 12 12
12 12 12 12 12 12 30 11 41 41 41 41 41 41 41 39 40 42 41 41 42 41 41 42 40 41 41 41 41 39 41 41 41 41 40 42 12 12 13 12 12 42 40 41 39 41 39 39 39 39 39 39 39 31 13 13 13 13 12 12
12 12 13 13 13 13 30 11 14 15 15 15 15 15 16 39 40 42 41 41 42 41 41 42 40 41 41 41 41 39 41 41 41 41 40 42 13 12 12 12 13 42 40 41 39 14 15 15 15 15 15 16 11 31 12 12 12 12 12 12
12 12 12 12 12 12 30 11 17 12 12 13 12 12 18 39 40 42 41 41 42 41 41 42 40 41 41 41 41 39 41 41 41 41 40 42 12 12 13 12 12 42 40 41 39 17 12 12 13 12 12 18 11 31 12 12 12 12 12 12
12 12 12 12 12 12 30 11 17 12 13 12 12 13 18 39 40 42 42 42 42 42 42 42 40 41 41 41 41 39 41 41 41 41 40 42 42 42 42 42 42 42 40 41 39 17 12 13 12 12 13 18 11 31 12 12 12 12 12 12
12 12 12 12 12 12 30 11 17 12 12 13 12 12 18 39 40 40 40 39 39 39 40 40 40 41 41 41 41 39 41 41 41 41 40 40 40 39 39 39 40 40 40 41 39 17 12 12 13 12 12 18 11 31 12 12 12 12 12 12
12 12 12 12 12 12 30 11 17 12 13 12 12 13 18 39 41 41 41 39 39 39 41 41 41 41 41 41 41 39 41 41 41 41 41 41 41 39 39 39 41 41 41 41 39 17 12 13 12 12 13 18 11 31 12 12 12 12 12 12
12 12 12 12 12 12 30 11 17 12 12 13 12 12 18 39 39 39 39 39 39 39 39 39 39 39 39 39 39 39 39 39 39 39 39 39 39 39 39 39 39 39 39 39 39 17 12 12 13 12 12 18 11 31 13 13 13 13 12 12
12 12 13 13 13 13 30 11 17 12 13 12 12 13 18 39 41 41 41 41 41 41 41 41 41 41 41 41 41 39 41 41 41 41 41 41 41 41 41 41 41 41 41 41 39 17 12 13 12 12 13 18 11 31 12 12 12 12 12 12
12 12 12 12 12 12 30 11 17 12 12 13 12 12 18 39 40 40 40 40 40 40 40 40 40 41 41 41 41 39 41 41 41 41 40 40 40 40 40 40 40 40 40 41 39 17 12 12 13 12 12 18 11 31 12 12 12 12 12 12
12 12 12 12 12 12 30 11 17 12 13 12 12 13 18 39 40 42 42 42 42 42 42 42 40 41 41 41 41 39 41 41 41 41 40 42 42 42 42 42 42 42 40 41 39 17 12 13 12 12 13 18 11 31 12 12 12 12 12 12
12 12 12 12 12 12 30 11 17 12 12 13 12 12 18 39 40 42 12 12 13 12 12 42 40 41 41 41 41 39 41 41 41 41 40 42 12 12 13 12 12 42 40 41 39 17 12 12 13 12 12 18 11 31 12 12 12 12 12 12
12 12 12 12 12 12 30 11 19 20 20 20 20 20 21 39 40 42 13 12 12 12 13 42 40 41 41 41 41 39 41 41 41 41 40 42 13 12 12 12 13 42 40 41 39 19 20 20 20 20 20 21 11 31 12 12 12 12 12 12
12 12 12 12 12 12 30 11 41 39 39 39 39 39 39 39 40 42 12 12 13 12 12 42 40 41 41 41 41 39 41 41 41 41 40 42 12 12 13 12 12 42 40 41 39 39 39 39 39 39 39 39 11 31 13 13 13 13 12 12
12 12 13 13 13 13 30 11 41 27 28 28 28 29 41 39 40 42 13 12 12 12 13 42 40 41 41 41 41 39 41 41 41 41 40 42 13 12 12 12 13 42 40 41 39 41 27 28 28 28 29 41 39 31 12 12 12 12 12 12
12 12 12 12 12 12 30 11 41 30 40 40 40 31 41 39 40 42 12 12 13 12 12 42 40 41 41 41 41 39 41 41 41 41 40 42 12 12 13 12 12 42 40 41 39 41 30 40 40 40 31 41 39 31 12 12 12 12 12 12
12 12 12 12 12 12 30 11 41 30 40 41 41 31 41 39 40 42 13 12 12 12 13 42 40 41 41 41 41 39 41 41 41 41 40 42 13 12 12 12 13 42 40 41 39 41 30 40 41 41 31 41 39 31 12 12 12 12 12 12
12 12 12 12 12 12 30 11 41 30 40 41 41 31 41 39 40 42 12 12 13 12 12 42 40 41 41 41 41 39 41 41 41 41 40 42 12 12 13 12 12 42 40 41 39 41 30 40 41 41 31 41 39 31 12 12 12 12 12 12
12 12 12 12 12 12 30 11 41 30 40 41 41 31 41 39 40 42 13 12 12 12 13 42 40 41 41 41 39 39 39 41 41 41 40 42 13 12 12 12 13 42 40 41 39 41 30 40 41 41 31 41 39 31 12 12 12 12 12 12
12 12 12 12 12 12 30 11 41 30 40 41 41 31 41 39 40 42 12 12 13 12 12 42 40 41 14 15 15 15 15 15 16 41 40 42 12 12 13 12 12 42 40 41 39 41 30 40 41 41 31 41 39 31 13 13 13 13 12 12
12 12 13 13 13 13 30 11 41 30 40 43 41 31 41 39 40 42 13 12 12 12 13 42 40 41 17 12 12 13 12 12 18 41 40 42 13 12 12 12 13 42 40 41 39 41 30 40 43 41 31 41 39 31 12 12 12 12 12 12
12 12 12 12 12 12 30 11 41 30 40 43 43 39 39 39 40 42 12 12 13 12 12 42 40 41 17 12 13 12 12 13 18 41 40 42 12 12 13 12 12 42 40 41 39 41 30 40 43 43 39 39 39 31 12 12 12 12 12 12
12 12 12 12 12 12 30 11 41 30 40 43 41 31 41 39 40 42 13 12 12 12 13 42 40 41 17 12 12 13 12 12 18 41 40 42 13 12 12 12 13 42 40 41 39 41 30 40 43 41 31 41 39 31 12 12 12 12 12 12
12 12 12 12 12 12 30 11 41 30 40 41 41 31 41 39 40 42 12 12 13 12 12 42 40 41 17 12 13 12 12 13 18 41 40 42 12 12 13 12 12 42 40 41 39 41 30 40 41 41 31 41 39 31 12 12 12 12 12 12
12 12 12 12 12 12 30 11 41 30 40 41 41 31 41 39 40 42 13 12 12 12 13 42 40 41 17 12 12 13 12 12 18 41 40 42 13 12 12 12 13 42 40 41 39 41 30 40 41 41 31 41 39 31 12 12 12 12 12 12
12 12 12 12 12 12 30 11 41 30 40 41 41 31 41 39 40 42 12 12 13 12 12 42 40 41 17 12 13 12 12 13 18 41 40 42 12 12 13 12 12 42 40 41 39 41 30 40 41 41 31 41 39 31 13 13 13 13 12 12
12 12 13 13 13 13 30 11 41 30 40 40 40 31 41 39 40 42 42 42 42 42 42 42 40 41 17 12 12 13 12 12 18 41 40 42 42 42 42 42 42 42 40 41 39 41 30 40 40 40 31 41 39 31 12 12 12 12 12 12
12 12 12 12 12 12 30 11 41 32 33 33 33 34 41 39 40 40 40 39 39 39 40 40 40 41 17 12 13 12 12 13 18 41 40 40 40 39 39 39 40 40 40 41 39 39 32 33 33 33 34 39 39 31 12 12 12 12 12 12
12 12 12 12 12 12 30 11 41 41 41 41 41 41 41 39 41 41 41 39 39 39 41 41 41 41 17 12 12 13 12 12 18 41 41 41 41 39 39 39 41 41 41 41 41 39 39 39 39 39 39 39 39 31 12 12 12 12 12 12
12 12 12 12 12 12 30 11 39 39 39 39 39 39 39 39 41 41 41 39 39 39 41 41 41 41 19 20 20 20 20 20 21 41 41 41 41 39 39 39 41 41 41 41 41 41 41 41 41 41 41 41 11 31 12 12 12 12 12 12
12 12 12 12 12 12 30 11 11 11 11 11 11 11 11 11 11 11 11 11 11 11 11 11 11 11 11 11 11 11 11 11 11 11 11 11 11 11 11 11 11 11 11 11 11 11 11 11 11 11 11 11 11 31 12 12 12 12 12 12
12 12 12 12 12 12 32 33 33 33 33 33 33 33 33 33 33 33 33 33 33 33 33 33 33 33 33 33 33 33 33 33 33 33 33 33 33 33 33 33 33 33 33 33 33 33 33 33 33 33 33 33 33 34 12 12 12 12 12 12
13 12 13 12 12 12 13 12 12 12 12 12 13 12 12 12 12 12 13 12 12 12 12 12 13 12 12 12 12 12 13 12 12 12 12 12 13 12 12 12 12 12 13 12 12 12 12 12 13 12 12 12 12 12 13 12 12 12 12 12
12 12 12 12 12 13 12 12 12 12 12 13 12 12 12 12 12 13 12 12 12 12 12 13 12 12 12 12 12 13 12 12 12 12 12 13 12 12 12 12 12 13 12 12 12 12 12 13 12 12 12 12 12 13 12 12 12 12 12 13
13 12 12 12 12 12 13 12 12 12 12 12 13 12 12 12 12 12 13 12 12 12 12 12 13 12 12 12 12 12 13 12 12 12 12 12 13 12 12 12 12 12 13 12 12 12 12 12 13 12 12 12 12 12 13 12 12 12 12 12
12 12 12 12 12 13 12 12 12 12 12 13 12 12 12 12 12 13 12 12 12 12 12 13 12 12 12 12 12 13 12 12 12 12 12 13 12 12 12 12 12 13 12 12 12 12 12 13 12 12 12 12 12 13 12 12 12 12 12 13
12 12 12 12 12 12 12 12 12 12 12 12 12 12 12 12 12 12 12 12 12 12 12 12 12 12 12 12 12 12 12 12 12 12 12 12 12 12 12 12 12 12 12 12 12 12 12 12 12 12 12 12 12 12 12 12 12 12 12 12
12 12 12 12 12 12 12 12 12 12 12 12 12 12 12 12 12 12 12 12 12 12 12 12 12 12 12 12 12 12 12 12 12 12 12 12 12 12 12 12 12 12 12 12 12 12 12 12 12 12 12 12 12 12 12 12 12 12 12 12
