12 12 12 12 12 12 12 12 12 12 12 12 12 12 12 12 12 12 12 12 12 12 12 12 12 12 12 12 12 12 12 12 12 12 12 12 12 12 12 12 12 12 12 12 12 12 12 12 12 12 12 12 12 12 12 12 12 12 12 12
12 12 12 12 12 12 12 12 12 12 12 12 12 12 12 12 12 12 12 12 12 12 12 12 12 12 12 12 12 12 12 12 12 12 12 12 12 12 12 12 12 12 12 12 12 12 12 12 12 12 12 12 12 12 12 12 12 12 12 12
12 13 12 13 12 13 12 13 12 13 12 13 12 13 12 13 12 13 12 13 12 13 12 13 12 13 12 13 12 13 12 13 12 13 12 13 12 13 12 13 12 13 12 13 12 13 12 13 12 13 12 13 12 13 13 12 13 12 12 13
13 12 13 12 13 12 13 12 13 12 13 12 13 12 13 12 13 12 13 12 13 12 13 12 13 12 13 12 13 12 13 12 13 12 13 12 13 12 13 12 13 12 13 12 13 12 13 12 13 12 13 12 13 12 12 13 12 13 13 12
12 13 12 13 12 13 12 13 12 13 12 13 12 13 12 13 12 13 12 13 12 13 12 13 12 13 12 13 12 13 12 13 12 13 12 13 12 13 12 13 12 13 12 13 12 13 12 13 12 13 12 13 12 13 13 12 13 12 12 13
13 12 13 12 13 12 13 12 13 12 13 12 13 12 13 12 13 12 13 12 13 12 13 12 13 12 13 12 13 12 13 12 13 12 13 12 13 12 13 12 13 12 13 12 13 12 13 12 13 12 13 12 13 12 12 13 12 13 13 12
12 12 12 13 12 13 27 28 28 28 28 28 28 28 28 28 28 28 28 28 28 28 28 28 28 28 28 28 28 28 28 28 28 28 28 28 28 28 28 28 28 28 28 28 28 28 28 28 28 28 28 28 28 29 13 12 13 12 12 12
12 12 13 12 13 12 30 12 13 12 13 12 13 12 13 12 13 39 12 13 12 13 12 13 12 13 12 13 41 39 41 12 13 12 13 12 13 12 13 12 13 42 12 13 12 13 12 13 12 13 12 13 12 31 12 13 12 13 12 12
12 12 12 13 12 13 30 13 42 42 42 42 42 42 42 42 42 39 42 42 42 42 42 42 42 42 42 12 41 39 41 13 42 42 42 42 42 42 42 42 42 42 42 42 42 42 42 42 42 42 42 42 13 31 13 12 13 12 12 12
12 12 13 12 13 12 30 12 42 40 40 40 42 40 40 40 42 39 42 40 40 40 42 40 40 40 42 13 41 39 41 12 42 40 40 40 42 40 40 40 42 41 42 40 40 40 42 40 40 40 41 42 12 31 12 13 12 13 12 12
12 12 12 13 12 13 30 13 42 40 41 41 42 41 41 40 42 39 42 40 41 41 42 41 41 40 42 12 41 39 41 13 42 40 41 41 42 41 41 40 42 41 42 40 41 41 42 41 41 40 41 42 13 31 13 12 13 12 12 12
12 12 13 12 13 12 30 12 42 40 41 42 42 42 41 40 42 39 42 40 41 42 42 42 41 40 42 13 41 39 41 12 42 40 41 42 42 42 42 40 42 41 42 40 41 42 42 42 42 40 41 42 12 31 12 13 12 13 12 12
12 12 12 13 12 13 30 13 42 40 41 42 43 42 41 40 42 39 42 40 41 42 43 42 41 40 42 12 41 39 41 13 42 40 41 42 43 43 42 40 42 41 42 40 41 42 43 43 42 40 41 42 13 31 13 12 13 12 12 12
12 12 13 12 13 12 30 12 42 40 41 42 43 42 41 40 42 39 42 40 41 42 43 42 41 40 42 13 41 39 41 12 42 40 41 42 42 42 42 40 42 41 42 40 41 42 42 42 42 40 41 42 12 31 12 13 12 13 12 12
12 12 12 13 12 13 30 13 42 40 41 42 43 42 41 40 42 39 42 40 41 42 43 42 41 40 42 12 41 39 41 13 42 40 41 42 44 44 42 40 42 41 42 40 41 42 44 44 42 40 41 42 13 31 13 12 13 12 12 12
12 12 13 12 13 12 30 12 42 40 41 42 42 42 41 40 42 39 42 40 41 42 42 42 41 40 42 13 41 39 41 12 42 40 41 14 15 15 16 40 42 41 42 40 41 14 15 15 16 40 41 42 12 31 12 13 12 13 12 12
12 12 12 13 12 13 30 13 42 40 41 42 42 42 41 40 42 39 42 40 41 42 42 42 41 40 42 12 41 39 41 13 42 40 41 17 12 12 18 40 42 41 42 40 41 17 12 12 18 40 41 42 13 31 13 12 13 12 12 12
12 12 13 12 13 12 30 12 42 40 41 42 44 42 41 40 42 39 42 40 41 42 44 42 41 40 42 13 41 39 41 12 42 40 41 17 12 12 18 40 42 41 42 40 41 17 12 12 18 40 41 42 12 31 12 13 12 13 12 12
12 12 12 13 12 13 30 13 42 40 41 42 44 42 41 40 42 39 42 40 41 42 44 42 41 40 42 12 41 39 41 13 42 40 41 17 12 12 18 40 42 41 42 40 41 17 12 12 18 40 41 42 13 31 13 12 13 12 12 12
12 12 13 12 13 12 30 12 42 40 41 42 42 42 41 40 42 39 42 40 41 42 42 42 41 40 42 13 41 39 41 12 42 40 41 17 12 12 18 40 42 41 42 40 41 17 12 12 18 40 41 42 12 31 12 13 12 13 12 12
12 12 12 13 12 13 30 13 42 40 41 42 42 42 41 40 42 39 42 40 41 42 42 42 41 40 42 12 41 39 41 13 42 40 41 17 12 12 18 40 42 41 42 40 41 17 12 12 18 40 41 42 13 31 13 12 13 12 12 12
12 12 13 12 13 12 30 12 42 40 41 42 43 42 41 40 42 39 42 40 41 42 43 42 41 40 42 13 41 39 41 12 42 40 41 19 20 20 21 40 42 41 42 40 41 19 20 20 21 40 41 42 12 31 12 13 12 13 12 12
12 12 12 13 12 13 30 13 42 40 41 42 43 42 41 40 42 39 42 40 41 42 43 42 41 40 42 12 41 39 41 13 42 40 41 42 44 44 42 40 42 41 42 40 41 42 44 44 42 40 41 42 13 31 13 12 13 12 12 12
12 12 13 12 13 12 30 12 42 40 41 42 43 42 41 40 42 39 42 40 41 42 43 42 41 40 42 13 41 39 41 12 42 40 41 42 42 42 42 40 42 41 42 40 41 42 42 42 42 40 41 42 12 31 12 13 12 13 12 12
12 12 12 13 12 13 30 13 42 40 41 42 42 42 41 40 42 39 42 40 41 42 42 42 41 40 42 12 41 39 41 13 42 40 41 42 43 43 42 40 42 41 42 40 41 42 43 43 42 40 41 42 13 31 13 12 13 12 12 12
12 12 13 12 13 12 30 12 42 40 41 41 42 41 41 40 42 39 42 40 41 41 42 41 41 40 42 13 41 39 41 12 42 40 41 42 42 42 42 40 42 41 42 40 41 42 42 42 42 40 41 42 12 31 12 13 12 13 12 12
12 12 12 13 12 13 30 13 42 40 40 40 42 40 40 40 42 39 42 40 40 40 42 40 40 40 42 12 41 39 41 13 42 40 41 41 42 42 42 40 42 41 42 40 41 41 42 42 42 40 41 42 13 31 13 12 13 12 12 12
12 12 13 12 13 12 30 12 42 42 42 42 42 42 42 42 42 39 42 42 42 42 42 42 42 42 42 13 41 39 41 12 42 40 40 40 42 40 40 40 42 41 42 40 40 40 42 40 40 40 42 42 12 31 12 13 12 13 12 12
12 12 12 13 12 13 30 39 39 41 41 41 39 41 41 41 41 41 41 41 41 41 39 41 41 41 41 41 41 39 41 41 41 41 41 41 39 41 41 41 41 41 41 41 41 41 39 41 41 41 41 39 39 31 13 12 13 12 12 12
12 12 13 12 13 12 30 39 39 39 39 39 39 39 39 39 39 39 39 39 39 39 39 39 39 39 39 39 39 39 39 39 39 39 39 39 39 39 39 39 39 39 39 39 39 39 39 39 39 39 39 39 39 31 12 13 12 13 12 12
12 12 12 13 12 13 30 39 39 41 41 41 39 41 41 41 41 41 41 41 41 41 39 41 41 41 41 41 41 39 41 41 41 41 41 41 39 41 41 41 41 41 41 41 41 41 39 41 41 41 41 39 39 31 13 12 13 12 12 12
12 12 13 12 13 12 30 12 42 42 42 42 42 42 42 42 42 39 42 42 42 42 42 42 42 42 42 12 41 39 41 13 42 42 42 42 42 42 42 42 42 41 42 42 42 42 42 42 42 42 42 42 13 31 12 13 12 13 12 12
12 12 12 13 12 13 30 13 42 40 40 40 42 40 40 40 42 39 42 40 40 40 42 40 40 40 42 13 41 39 41 12 42 40 40 40 42 40 40 40 42 41 42 40 40 40 42 40 40 40 41 42 12 31 13 12 13 12 12 12
12 12 13 12 13 12 30 12 42 40 41 41 42 41 41 40 42 39 42 40 41 41 42 41 41 40 42 12 41 39 41 13 42 40 41 41 42 41 41 40 42 41 42 40 41 41 42 41 41 40 41 42 13 31 12 13 12 13 12 12
12 12 12 13 12 13 30 13 42 40 41 42 42 42 41 40 42 39 42 40 41 42 42 42 41 40 42 13 41 39 41 12 42 40 41 42 42 42 42 40 42 41 42 40 41 42 42 42 42 40 41 42 12 31 13 12 13 12 12 12
12 12 13 12 13 12 30 12 42 40 41 42 43 42 41 40 42 39 42 40 41 42 43 42 41 40 42 12 41 39 41 13 42 40 41 42 43 43 42 40 42 41 42 40 41 42 43 43 42 40 41 42 13 31 12 13 12 13 12 12
12 12 12 13 12 13 30 13 42 40 41 42 43 42 41 40 42 39 42 40 41 42 43 42 41 40 42 13 41 39 41 12 42 40 41 42 42 42 42 40 42 41 42 40 41 42 42 42 42 40 41 42 12 31 13 12 13 12 12 12
12 12 13 12 13 12 30 12 42 40 41 42 43 42 41 40 42 39 42 40 41 42 43 42 41 40 42 12 41 39 41 13 42 40 41 42 44 44 42 40 42 41 42 40 41 42 44 44 42 40 41 42 13 31 12 13 12 13 12 12
12 12 12 13 12 13 30 13 42 40 41 42 42 42 41 40 42 39 42 40 41 42 42 42 41 40 42 13 41 39 41 12 42 40 41 14 15 15 16 40 42 41 42 40 41 14 15 15 16 40 41 42 12 31 13 12 13 12 12 12
12 12 13 12 13 12 30 12 42 40 41 42 42 42 41 40 42 39 42 40 41 42 42 42 41 40 42 12 41 39 41 13 42 40 41 17 12 12 18 40 42 41 42 40 41 17 12 12 18 40 41 42 13 31 12 13 12 13 12 12
12 12 12 13 12 13 30 13 42 40 41 42 44 42 41 40 42 39 42 40 41 42 44 42 41 40 42 13 41 39 41 12 42 40 41 17 12 12 18 40 42 41 42 40 41 17 12 12 18 40 41 42 12 31 13 12 13 12 12 12
12 12 13 12 13 12 30 12 42 40 41 42 44 42 41 40 42 39 42 40 41 42 44 42 41 40 42 12 41 39 41 13 42 40 41 17 12 12 18 40 42 41 42 40 41 17 12 12 18 40 41 42 13 31 12 13 12 13 12 12
12 12 12 13 12 13 30 13 42 40 41 42 42 42 41 40 42 39 42 40 41 42 42 42 41 40 42 13 41 39 41 12 42 40 41 17 12 12 18 40 42 41 42 40 41 17 12 12 18 40 41 42 12 31 13 12 13 12 12 12
12 12 13 12 13 12 30 12 42 40 41 42 42 42 41 40 42 39 42 40 41 42 42 42 41 40 42 12 41 39 41 13 42 40 41 17 12 12 18 40 42 41 42 40 41 17 12 12 18 40 41 42 13 31 12 13 12 13 12 12
12 12 12 13 12 13 30 13 42 40 41 42 43 42 41 40 42 39 42 40 41 42 43 42 41 40 42 13 41 39 41 12 42 40 41 19 20 20 21 40 42 41 42 40 41 19 20 20 21 40 41 42 12 31 13 12 13 12 12 12
12 12 13 12 13 12 30 12 42 40 41 42 43 42 41 40 42 39 42 40 41 42 43 42 41 40 42 12 41 39 41 13 42 40 41 42 44 44 42 40 42 41 42 40 41 42 44 44 42 40 41 42 13 31 12 13 12 13 12 12
12 12 12 13 12 13 30 13 42 40 41 42 43 42 41 40 42 39 42 40 41 42 43 42 41 40 42 13 41 39 41 12 42 40 41 42 42 42 42 40 42 41 42 40 41 42 42 42 42 40 41 42 12 31 13 12 13 12 12 12
12 12 13 12 13 12 30 12 42 40 41 42 42 42 41 40 42 39 42 40 41 42 42 42 41 40 42 12 41 39 41 13 42 40 41 42 43 43 42 40 42 41 42 40 41 42 43 43 42 40 41 42 13 31 12 13 12 13 12 12
12 12 12 13 12 13 30 13 42 40 41 41 42 41 41 40 42 39 42 40 41 41 42 41 41 40 42 13 41 39 41 12 42 40 41 42 42 42 42 40 42 41 42 40 41 42 42 42 42 40 41 42 12 31 13 12 13 12 12 12
12 12 13 12 13 12 30 12 42 40 40 40 42 40 40 40 42 39 42 40 40 40 42 40 40 40 42 12 41 39 41 13 42 40 41 41 42 42 42 40 42 41 42 40 41 41 42 42 42 40 41 42 13 31 12 13 12 13 12 12
12 12 12 13 12 13 30 13 42 42 42 42 42 42 42 42 42 39 42 42 42 42 42 42 42 42 42 13 41 39 41 12 42 40 40 40 42 40 40 40 42 42 42 40 40 40 42 40 40 40 41 42 12 31 13 12 13 12 12 12
12 12 13 12 13 12 30 12 42 42 42 42 42 42 42 42 42 39 42 42 42 42 42 42 42 42 42 12 41 39 41 13 42 42 42 42 42 42 42 42 42 42 42 42 42 42 42 42 42 42 42 42 13 31 12 13 12 13 12 12
12 12 12 13 12 13 30 13 12 13 12 13 12 13 12 13 12 39 12 13 12 13 12 13 12 13 12 13 41 39 41 12 13 12 13 12 13 12 13 12 13 42 12 13 12 13 12 13 12 13 12 13 12 31 13 12 13 12 12 12
12 12 13 12 13 12 32 33 33 33 33 33 33 33 33 33 33 33 33 33 33 33 33 33 33 33 33 33 33 33 33 33 33 33 33 33 33 33 33 33 33 33 33 33 33 33 33 33 33 33 33 33 33 34 12 13 12 13 12 12
13 12 12 12 12 12 13 12 13 12 13 12 13 12 13 12 13 12 13 12 13 12 13 12 13 12 13 12 13 12 13 12 13 12 13 12 13 12 13 12 13 12 13 12 13 12 13 12 13 12 13 12 13 12 12 12 12 12 13 12
12 13 13 13 13 13 12 13 12 13 12 13 12 13 12 13 12 13 12 13 12 13 12 13 12 13 12 13 12 13 12 13 12 13 12 13 12 13 12 13 12 13 12 13 12 13 12 13 12 13 12 13 12 13 13 13 13 13 12 13
13 12 12 12 12 12 13 12 13 12 13 12 13 12 13 12 13 12 13 12 13 12 13 12 13 12 13 12 13 12 13 12 13 12 13 12 13 12 13 12 13 12 13 12 13 12 13 12 13 12 13 12 13 12 12 12 12 12 13 12
12 13 13 13 13 13 12 13 12 13 12 13 12 13 12 13 12 13 12 13 12 13 12 13 12 13 12 13 12 13 12 13 12 13 12 13 12 13 12 13 12 13 12 13 12 13 12 13 12 13 12 13 12 13 13 13 13 13 12 13
12 12 12 12 12 12 12 12 12 12 12 12 12 12 12 12 12 12 12 12 12 12 12 12 12 12 12 12 12 12 12 12 12 12 12 12 12 12 12 12 12 12 12 12 12 12 12 12 12 12 12 12 12 12 12 12 12 12 12 12
12 12 13 12 13 12 12 12 12 12 12 12 12 12 12 12 12 12 12 12 12 12 12 12 12 12 12 12 12 12 12 12 12 12 12 12 12 12 12 12 12 12 12 12 12 12 12 12 12 12 12 12 12 12 12 13 12 13 12 12

